                                                                                              CC                                        C                 CC                              C                                     |             C
                                                                                CCC       G                            C                        CCC G                          C                      CCC                       |  C                   CCC
                C            ?           C                       C                  BBBBBBBBBBBB   BBB?                   ?                BBB     B??B                                                             SS          |      
                                                        CCC                                                                                                                                                        SSS          |      
S                                                                                                                                                                                                                 SSSS          |      
S                                                                                 G                                                                                                                              SSSSS          |                        D
S                      ?   B?B?B                      P          P               B?B                 B        B?       ?  ?  ?         B            BB      S  S            SS  S              BB?B             SSSSSS          |                        D
S                                             P       P          P                                                                                         SS  SS          SSS  SS                             SSSSSSS          |                        D
S                                   P         P       P          P                                                                                        SSS  SSS        SSSS  SSS      P                  P SSSSSSSS          |                        D
S      HM          ^^^  h    G  ^   P         PG  ^^  P   HG G   P ^^^ h      ^                   ^^ GG  H               ^^^  h          ^    GG GG      SSSS^^SSSS   H  SSSSS  SSSS     P        GG        PSSSSSSSSS     H    S     #   ^   h     ^    D
FFFFFFFFFFFFFFFFFFFFFFFFFFFFFFFFFFFFFFFFFFFFFFFFFFFFFFFFFFFFFFFFFFFFFFFFFFFWWFFFFFFFFFFFFFFFFWWWFFFFFFFFFFFFFFFFFFFFFFFFFFFFFFFFFFFFFFFFFFFFFFFFFFFFFFFFFFFFFFFFFFFFFFFFFFFFFFWWFFFFFFFFFFFFFFFFFFFFFFFFFFFFFFFFFFFFFFFFFFFFFFFFFFFFFFFFFFFFFFFFFFFFFFFFFF
DDDDDDDDDDDDDDDDDDDDDDDDDDDDDDDDDDDDDDDDDDDDDDDDDDDDDDDDDDDDDDDDDDDDDDDDDDDDDDDDDDDDDDDDDDDDDDDDDDDDDDDDDDDDDDDDDDDDDDDDDDDDDDDDDDDDDDDDDDDDDDDDDDDDDDDDDDDDDDDDDDDDDDDDDDDDDDDDDDDDDDDDDDDDDDDDDDDDDDDDDDDDDDDDDDDDDDDDDDDDDDDDDDDDDDDDDDDDDDDDDDDDDDDDDD