                                                                               G                                                         G                                                                 
                  ?                                                      BBBBBBBBBBBB   BBB?                   ?                BBB     B??V                                                             SS
                                                                                                                                                                                                        SSS
S                                                                                                                                                                                                      SSSS
S                                                                      G                                                                                                                              SSSSS
S           ?   B?B?B                      P          P               B?B                 B        B?       ?  ?  ?         B            BB      S  S            SS  S              BB?B             SSSSSS
S                                  P       P          P                                                                                         SS  SS          SSS  SS                             SSSSSSS
SM                       P         P       P          P                                                                                        SSS  SSS        SSSS  SSS      P                  P SSSSSSSS
S                 G      P         P   G   P    G G   P                                   GG                                       GG GG      SSSS  SSSS      SSSSS  SSSS     P        GG        PSSSSSSSSS          S
FFFFFFFFFFFFFFFFFFFFFFFFFFFFFFFFFFFFFFFFFFFFFFFFFFFFFFFFFFFFFFFF  FFFFFFFFFFFFFFFF   FFFFFFFFFFFFFFFFFFFFFFFFFFFFFFFFFFFFFFFFFFFFFFFFFFFFFFFFFFFFFFFFFFFFFFFFFFFFFF  FFFFFFFFFFFFFFFFFFFFFFFFFFFFFFFFFFFFFFWWWWWWWWWFFFWWWWWWWWWWW
DDDDDDDDDDDDDDDDDDDDDDDDDDDDDDDDDDDDDDDDDDDDDDDDDDDDDDDDDDDDDDDDDDDDDDDDDDDDDDDDDDDDDDDDDDDDDDDDDDDDDDDDDDDDDDDDDDDDDDDDDDDDDDDDDDDDDDDDDDDDDDDDDDDDDDDDDDDDDDDDDDDDDDDDDDDDDDDDDDDDDDDDDDDDDDDDDDDDDDDDDDDDDDDDDDDDDDDDDDDDDDDDDD